############################
#..........................#
#.########################.#
#.########################.#
#.########################.#
#.########################.#
#.########################.#
#.########################.#
#......##############......#
######.##### ## #####.######
#    #.##### ## #####.#    #
#    #.##          ##.#    #
#    #.## ######## ##.#    #
######.## ######## ##.######
_     .#            #.     _
######.##############.######
#    #.## ######## ##.#    #
#    #.##          ##.#    #
#    #.## ######## ##.#    #
######.## ######## ##.######
######.##############.######
######.##############.######
######.##############.######
######.......p .......######
######.##############.######
######.##############.######
#......##############......#
#.########################.#
#.########################.#
#..........................#
############################
